NOC,Year,Sport,Bronze,Gold,Silver,Total Medals,Year Total Medals,Medal Share (%)
AFG,2008,Taekwondo,1,0,0,1,1,100.0
AFG,2012,Taekwondo,1,0,0,1,1,100.0
AHO,1988,Sailing,0,0,1,1,1,100.0
ALB,2024,Wrestling,2,0,0,2,2,100.0
ALG,1984,Boxing,2,0,0,2,2,100.0
ALG,1996,Boxing,1,1,0,2,3,66.66666666666666
ALG,2000,Athletics,2,1,1,4,5,80.0
ALG,2008,Judo,1,0,1,2,2,100.0
ALG,2012,Athletics,0,1,0,1,1,100.0
ALG,2016,Athletics,0,0,2,2,2,100.0
ANZ,1908,Rugby,0,15,0,15,19,78.94736842105263
ANZ,1912,Swimming,2,5,2,9,10,90.0
ARG,1928,Football,0,0,16,16,26,61.53846153846154
ARG,1932,Boxing,0,2,1,3,4,75.0
ARG,1960,Sailing,0,0,3,3,4,75.0
ARG,1964,Equestrianism,0,0,1,1,1,100.0
ARG,1972,Rowing,0,0,1,1,1,100.0
ARG,1988,Volleyball,12,0,0,12,13,92.3076923076923
ARG,1992,Tennis,2,0,0,2,2,100.0
ARG,1996,Football,0,0,18,18,20,90.0
ARG,2000,Hockey,0,0,16,16,20,80.0
ARG,2012,Hockey,0,0,15,15,19,78.94736842105263
ARG,2016,Hockey,0,18,0,18,22,81.81818181818183
ARG,2024,Hockey,16,0,0,16,19,84.21052631578947
ARM,1996,Wrestling,0,1,1,2,2,100.0
ARM,2000,Weightlifting,1,0,0,1,1,100.0
ARM,2012,Wrestling,1,0,1,2,3,66.66666666666666
AUS,1896,Athletics,0,2,0,2,3,66.66666666666666
AUS,1900,Athletics,3,1,0,4,6,66.66666666666666
AUS,1904,Swimming,1,0,3,4,4,100.0
AUS,1906,Athletics,2,0,0,2,3,66.66666666666666
AUS,1920,Swimming,1,0,5,6,7,85.71428571428571
AUS,1924,Swimming,2,1,5,8,10,80.0
AUS,1936,Athletics,1,0,0,1,1,100.0
AUS,1948,Athletics,2,1,6,9,16,56.25
AUS,1960,Swimming,8,5,21,34,46,73.91304347826086
AUS,1976,Hockey,0,0,15,15,23,65.21739130434783
AUS,1980,Swimming,5,6,0,11,13,84.61538461538461
AUT,1896,Cycling,2,1,0,3,5,60.0
AUT,1900,Swimming,1,0,3,4,6,66.66666666666666
AUT,1904,Gymnastics,0,2,1,3,4,75.0
AUT,1908,Swimming,1,0,0,1,1,100.0
AUT,1912,Fencing,1,0,7,8,14,57.14285714285714
AUT,1924,Weightlifting,1,0,3,4,4,100.0
AUT,1952,Canoeing,2,0,1,3,3,100.0
AUT,1960,Rowing,0,0,2,2,3,66.66666666666666
AUT,1976,Shooting,1,0,0,1,1,100.0
AUT,1980,Sailing,0,0,3,3,5,60.0
AUT,1984,Judo,1,1,0,2,3,66.66666666666666
AUT,1988,Judo,0,1,0,1,1,100.0
AUT,1992,Equestrianism,0,0,4,4,6,66.66666666666666
AUT,1996,Shooting,1,0,1,2,3,66.66666666666666
AUT,2000,Sailing,0,3,0,3,4,75.0
AUT,2016,Sailing,2,0,0,2,2,100.0
AZE,1996,Wrestling,0,0,1,1,1,100.0
AZE,2008,Wrestling,2,0,2,4,7,57.14285714285714
AZE,2012,Wrestling,3,2,2,7,10,70.0
BAH,1956,Sailing,2,0,0,2,2,100.0
BAH,1964,Sailing,0,2,0,2,2,100.0
BAH,1992,Athletics,1,0,0,1,1,100.0
BAH,1996,Athletics,0,0,5,5,5,100.0
BAH,2000,Athletics,5,6,0,11,11,100.0
BAH,2004,Athletics,1,1,0,2,2,100.0
BAH,2008,Athletics,1,0,6,7,7,100.0
BAH,2012,Athletics,0,4,0,4,4,100.0
BAH,2016,Athletics,5,1,0,6,6,100.0
BAH,2020,Athletics,0,2,0,2,2,100.0
BAR,2000,Athletics,1,0,0,1,1,100.0
BDI,1996,Athletics,0,1,0,1,1,100.0
BDI,2016,Athletics,0,0,1,1,1,100.0
BEL,1906,Fencing,4,2,0,6,11,54.54545454545454
BEL,1928,Rowing,3,0,0,3,5,60.0
BEL,1932,Art Competitions,1,0,0,1,1,100.0
BEL,1936,Water Polo,9,0,0,9,14,64.28571428571429
BEL,1952,Cycling,0,5,1,6,8,75.0
BEL,1964,Cycling,1,1,0,2,3,66.66666666666666
BEL,1968,Cycling,2,0,0,2,3,66.66666666666666
BEL,1972,Athletics,0,0,2,2,2,100.0
BEL,1976,Equestrianism,5,0,0,5,9,55.55555555555556
BEL,1980,Judo,0,1,0,1,1,100.0
BEL,1984,Rowing,1,0,2,3,5,60.0
BEL,1996,Judo,2,1,1,4,6,66.66666666666666
BEL,2008,Athletics,0,1,4,5,5,100.0
BEL,2016,Hockey,0,0,16,16,21,76.19047619047619
BEL,2020,Hockey,0,18,0,18,27,66.66666666666666
BER,1976,Boxing,1,0,0,1,1,100.0
BER,2020,Triathlon,0,1,0,1,1,100.0
BOH,1900,Tennis,2,0,0,2,3,66.66666666666666
BOH,1906,Tennis,3,0,0,3,3,100.0
BOH,1908,Fencing,6,0,0,6,6,100.0
BOT,2012,Athletics,0,0,1,1,1,100.0
BOT,2020,Athletics,6,0,0,6,6,100.0
BOT,2024,Athletics,0,1,6,7,7,100.0
BRA,1920,Shooting,5,1,1,7,7,100.0
BRA,1948,Basketball,10,0,0,10,10,100.0
BRA,1952,Athletics,1,1,0,2,3,66.66666666666666
BRA,1956,Athletics,0,1,0,1,1,100.0
BRA,1960,Basketball,12,0,0,12,13,92.3076923076923
BRA,1964,Basketball,12,0,0,12,12,100.0
BRA,1976,Sailing,2,0,0,2,3,66.66666666666666
BRA,1988,Football,0,0,16,16,23,69.56521739130434
BRA,1992,Volleyball,0,12,0,12,14,85.71428571428571
BRN,2012,Athletics,1,0,0,1,1,100.0
BRN,2016,Athletics,0,1,1,2,2,100.0
BRN,2020,Athletics,0,0,1,1,1,100.0
BUL,1952,Boxing,1,0,0,1,1,100.0
BUL,1956,Football,14,0,0,14,18,77.77777777777779
BUL,1960,Wrestling,2,1,3,6,7,85.71428571428571
BUL,1964,Wrestling,1,3,4,8,10,80.0
BUL,1968,Football,0,0,18,18,26,69.23076923076923
BUL,2008,Wrestling,3,0,1,4,5,80.0
BUL,2016,Rhythmic Gymnastics,5,0,0,5,7,71.42857142857143
BUR,2020,Athletics,1,0,0,1,1,100.0
CAN,1900,Athletics,1,1,0,2,2,100.0
CAN,1906,Athletics,0,1,1,2,2,100.0
CAN,1912,Athletics,2,1,2,5,8,62.5
CAN,1924,Rowing,0,0,13,13,20,65.0
CAN,1948,Athletics,4,0,0,4,7,57.14285714285714
CAN,1956,Rowing,0,4,9,13,19,68.42105263157895
CAN,1960,Rowing,0,0,9,9,9,100.0
CAN,1968,Swimming,4,0,3,7,10,70.0
CAN,1972,Swimming,6,0,2,8,11,72.72727272727273
CAN,1976,Swimming,14,0,6,20,23,86.95652173913044
CAN,1992,Rowing,1,24,0,25,44,56.81818181818182
CHI,1928,Athletics,0,0,1,1,1,100.0
CHI,1952,Equestrianism,0,0,4,4,4,100.0
CHI,1956,Boxing,2,0,1,3,4,75.0
CHI,1988,Shooting,0,0,1,1,1,100.0
CHI,2000,Football,17,0,0,17,17,100.0
CHI,2004,Tennis,1,3,0,4,4,100.0
CHI,2008,Tennis,0,0,1,1,1,100.0
CIV,1984,Athletics,0,0,1,1,1,100.0
CIV,2016,Taekwondo,1,1,0,2,2,100.0
CIV,2020,Taekwondo,1,0,0,1,1,100.0
CIV,2024,Taekwondo,1,0,0,1,1,100.0
CMR,1968,Boxing,0,0,1,1,1,100.0
CMR,1984,Boxing,1,0,0,1,1,100.0
CMR,2000,Football,0,18,0,18,18,100.0
CMR,2004,Athletics,0,1,0,1,1,100.0
CMR,2008,Athletics,0,1,0,1,1,100.0
COL,1900,Tug-Of-War,0,0,1,1,1,100.0
COL,1972,Boxing,2,0,0,2,3,66.66666666666666
COL,1984,Shooting,0,0,1,1,1,100.0
COL,1988,Boxing,1,0,0,1,1,100.0
COL,1992,Athletics,1,0,0,1,1,100.0
COL,2000,Weightlifting,0,1,0,1,1,100.0
CPV,2024,Boxing,1,0,0,1,1,100.0
CRC,1988,Swimming,0,0,1,1,1,100.0
CRC,1996,Swimming,0,1,0,1,1,100.0
CRC,2000,Swimming,2,0,0,2,2,100.0
CRO,1992,Basketball,0,0,12,12,15,80.0
CRO,1996,Handball,0,16,0,16,28,57.14285714285714
CRO,2000,Rowing,9,0,0,9,10,90.0
CRO,2004,Handball,0,15,0,15,21,71.42857142857143
CRO,2016,Water Polo,0,0,13,13,24,54.166666666666664
CRO,2024,Water Polo,0,0,13,13,20,65.0
CUB,1900,Fencing,0,1,1,2,2,100.0
CUB,1904,Fencing,0,5,0,5,5,100.0
CUB,1948,Sailing,0,0,2,2,2,100.0
CUB,1964,Athletics,0,0,1,1,1,100.0
CUB,1968,Athletics,0,0,8,8,10,80.0
CUB,1972,Basketball,12,0,0,12,22,54.54545454545454
CUB,2008,Baseball,0,0,24,24,47,51.06382978723404
CUB,2016,Boxing,3,3,0,6,11,54.54545454545454
CUB,2024,Wrestling,3,1,1,5,9,55.55555555555556
CYP,2012,Sailing,0,0,1,1,1,100.0
CYP,2024,Sailing,0,0,1,1,1,100.0
DEN,1906,Gymnastics,0,0,18,18,34,52.94117647058824
DEN,1908,Football,0,0,13,13,17,76.47058823529412
DEN,1912,Gymnastics,20,0,28,48,87,55.172413793103445
DEN,1920,Gymnastics,0,20,25,45,71,63.38028169014085
DEN,1956,Sailing,0,1,3,4,6,66.66666666666666
DEN,1960,Football,0,0,12,12,23,52.17391304347826
DEN,1972,Cycling,0,1,0,1,1,100.0
DEN,1976,Cycling,5,0,0,5,8,62.5
DEN,1980,Sailing,0,3,2,5,8,62.5
DEN,1984,Rowing,9,0,0,9,13,69.23076923076923
DEN,1988,Sailing,3,2,0,5,7,71.42857142857143
DEN,1996,Handball,0,15,0,15,23,65.21739130434783
DEN,2000,Handball,0,15,0,15,25,60.0
DEN,2004,Handball,0,15,0,15,29,51.724137931034484
DEN,2024,Handball,15,16,0,31,41,75.60975609756098
DJI,1988,Athletics,1,0,0,1,1,100.0
DMA,2024,Athletics,0,1,0,1,1,100.0
DOM,1984,Boxing,1,0,0,1,1,100.0
DOM,2004,Athletics,0,1,0,1,1,100.0
DOM,2012,Athletics,0,1,1,2,2,100.0
DOM,2016,Taekwondo,1,0,0,1,1,100.0
DOM,2020,Baseball/Softball,24,0,0,24,32,75.0
DOM,2024,Boxing,2,0,0,2,3,66.66666666666666
ECU,1996,Athletics,0,1,0,1,1,100.0
ECU,2008,Athletics,0,0,1,1,1,100.0
ECU,2020,Weightlifting,0,1,1,2,3,66.66666666666666
EGY,1936,Weightlifting,2,2,1,5,5,100.0
EGY,1948,Weightlifting,0,2,1,3,5,60.0
EGY,1952,Wrestling,1,0,0,1,1,100.0
EGY,1984,Judo,0,0,1,1,1,100.0
EGY,2004,Boxing,2,0,1,3,5,60.0
EGY,2008,Judo,1,0,0,1,1,100.0
EGY,2016,Weightlifting,2,0,0,2,3,66.66666666666666
EOR,2024,Boxing,1,0,0,1,1,100.0
ERI,2004,Athletics,1,0,0,1,1,100.0
ESP,1900,Basque Pelota,0,2,0,2,2,100.0
ESP,1920,Football,0,0,18,18,23,78.26086956521739
ESP,1928,Equestrianism,0,3,0,3,3,100.0
ESP,1932,Sailing,1,0,0,1,1,100.0
ESP,1948,Equestrianism,0,0,3,3,3,100.0
ESP,1952,Shooting,0,0,1,1,1,100.0
ESP,1960,Hockey,14,0,0,14,14,100.0
ESP,1972,Boxing,1,0,0,1,1,100.0
ESP,1976,Canoeing,0,0,4,4,6,66.66666666666666
ESP,1980,Hockey,0,0,16,16,24,66.66666666666666
ESP,1984,Basketball,0,0,12,12,19,63.1578947368421
ESP,2016,Basketball,12,0,12,24,45,53.333333333333336
EST,1920,Weightlifting,0,1,1,2,3,66.66666666666666
EST,1928,Sailing,5,0,0,5,9,55.55555555555556
EST,1936,Wrestling,2,2,1,5,7,71.42857142857143
EST,1992,Sailing,2,0,0,2,3,66.66666666666666
EST,2000,Judo,2,0,0,2,3,66.66666666666666
EST,2008,Rowing,0,0,2,2,3,66.66666666666666
EST,2016,Rowing,4,0,0,4,4,100.0
EST,2020,Fencing,1,4,0,5,5,100.0
ETH,1960,Athletics,0,1,0,1,1,100.0
ETH,1964,Athletics,0,1,0,1,1,100.0
ETH,1968,Athletics,0,1,1,2,2,100.0
ETH,1972,Athletics,2,0,0,2,2,100.0
ETH,1980,Athletics,2,2,0,4,4,100.0
ETH,1992,Athletics,2,1,0,3,3,100.0
ETH,1996,Athletics,1,2,0,3,3,100.0
ETH,2000,Athletics,3,4,1,8,8,100.0
ETH,2004,Athletics,2,2,3,7,7,100.0
ETH,2008,Athletics,2,4,1,7,7,100.0
ETH,2012,Athletics,3,3,1,7,7,100.0
ETH,2016,Athletics,5,1,2,8,8,100.0
ETH,2020,Athletics,2,1,1,4,4,100.0
ETH,2024,Athletics,0,1,3,4,4,100.0
FIJ,2016,Rugby Sevens,0,13,0,13,13,100.0
FIJ,2020,Rugby Sevens,13,13,0,26,26,100.0
FIJ,2024,Rugby Sevens,0,0,14,14,14,100.0
FIN,1908,Gymnastics,26,0,0,26,30,86.66666666666667
FIN,1924,Athletics,2,20,5,27,52,51.92307692307693
FIN,1928,Athletics,4,5,5,14,25,56.00000000000001
FIN,1948,Gymnastics,2,13,2,17,33,51.515151515151516
FIN,1976,Athletics,0,2,2,4,6,66.66666666666666
FIN,2012,Sailing,3,0,1,4,5,80.0
FIN,2016,Boxing,1,0,0,1,1,100.0
FRA,1896,Cycling,1,4,1,6,11,54.54545454545454
FRA,1904,Athletics,0,0,2,2,2,100.0
FRA,1976,Fencing,6,0,5,11,20,55.00000000000001
FRA,1980,Fencing,1,16,1,18,29,62.06896551724138
GAB,2012,Taekwondo,0,0,1,1,1,100.0
GBR,1904,Athletics,0,1,1,2,2,100.0
GBR,1964,Athletics,4,4,10,18,28,64.28571428571429
GEO,2008,Wrestling,2,2,0,4,6,66.66666666666666
GEO,2012,Wrestling,3,0,3,6,7,85.71428571428571
GER,1896,Gymnastics,2,23,3,28,32,87.5
GHA,1960,Boxing,0,0,1,1,1,100.0
GHA,1964,Boxing,1,0,0,1,1,100.0
GHA,1972,Boxing,1,0,0,1,1,100.0
GHA,1992,Football,20,0,0,20,20,100.0
GHA,2020,Boxing,1,0,0,1,1,100.0
GRE,1908,Athletics,0,0,3,3,4,75.0
GRE,1912,Athletics,1,1,0,2,2,100.0
GRE,1920,Shooting,0,0,5,5,5,100.0
GRE,1924,Art Competitions,0,1,0,1,1,100.0
GRE,1956,Athletics,1,0,0,1,1,100.0
GRE,1960,Sailing,0,3,0,3,3,100.0
GRE,1968,Wrestling,1,0,0,1,1,100.0
GRE,1980,Sailing,3,0,0,3,5,60.0
GRE,1984,Wrestling,1,0,1,2,2,100.0
GRE,1988,Wrestling,1,0,0,1,1,100.0
GRE,1996,Weightlifting,0,2,3,5,8,62.5
GRE,2012,Rowing,2,0,0,2,3,66.66666666666666
GRE,2020,Water Polo,0,0,13,13,16,81.25
GRN,2012,Athletics,0,1,0,1,1,100.0
GRN,2016,Athletics,0,0,1,1,1,100.0
GRN,2020,Athletics,1,0,0,1,1,100.0
GRN,2024,Athletics,2,0,0,2,2,100.0
GUA,2012,Athletics,0,0,1,1,1,100.0
GUA,2024,Shooting,1,1,0,2,2,100.0
GUY,1980,Boxing,1,0,0,1,1,100.0
HAI,1900,Rugby,0,1,0,1,1,100.0
HAI,1924,Shooting,5,0,0,5,5,100.0
HAI,1928,Athletics,0,0,1,1,1,100.0
HKG,1996,Sailing,0,1,0,1,1,100.0
HKG,2004,Table Tennis,0,0,2,2,2,100.0
HKG,2012,Cycling,1,0,0,1,1,100.0
HUN,1900,Swimming,1,0,2,3,5,60.0
HUN,1904,Swimming,1,2,1,4,4,100.0
HUN,1912,Gymnastics,0,0,16,16,30,53.333333333333336
HUN,1924,Fencing,6,1,8,15,22,68.18181818181817
HUN,2012,Canoeing,1,7,6,14,26,53.84615384615385
HUN,2020,Water Polo,26,0,0,26,51,50.98039215686274
INA,1988,Archery,0,0,3,3,3,100.0
INA,1992,Badminton,1,2,3,6,6,100.0
INA,1996,Badminton,3,2,1,6,6,100.0
INA,2000,Badminton,0,2,3,5,8,62.5
INA,2004,Badminton,3,1,0,4,5,80.0
INA,2008,Badminton,1,2,2,5,7,71.42857142857143
INA,2012,Weightlifting,1,0,1,2,2,100.0
IND,1900,Athletics,0,0,2,2,2,100.0
IND,1928,Hockey,0,14,0,14,14,100.0
IND,1932,Hockey,0,15,0,15,15,100.0
IND,1936,Hockey,0,19,0,19,19,100.0
IND,1948,Hockey,0,20,0,20,20,100.0
IND,1952,Hockey,0,14,0,14,15,93.33333333333333
IND,1956,Hockey,0,17,0,17,17,100.0
IND,1960,Hockey,0,0,13,13,13,100.0
IND,1964,Hockey,0,15,0,15,15,100.0
IND,1968,Hockey,16,0,0,16,16,100.0
IND,1972,Hockey,14,0,0,14,14,100.0
IND,1980,Hockey,0,16,0,16,16,100.0
IND,1996,Tennis,1,0,0,1,1,100.0
IND,2000,Weightlifting,1,0,0,1,1,100.0
IND,2004,Shooting,0,0,1,1,1,100.0
IND,2020,Hockey,18,0,0,18,24,75.0
IND,2024,Hockey,16,0,0,16,22,72.72727272727273
IOA,1992,Shooting,2,0,1,3,3,100.0
IOA,2016,Shooting,1,1,0,2,2,100.0
IRI,1948,Weightlifting,1,0,0,1,1,100.0
IRI,1952,Wrestling,3,0,2,5,7,71.42857142857143
IRI,1956,Wrestling,0,2,2,4,5,80.0
IRI,1960,Wrestling,2,0,1,3,4,75.0
IRI,1964,Wrestling,2,0,0,2,2,100.0
IRI,1968,Wrestling,2,1,0,3,5,60.0
IRI,1972,Wrestling,1,0,1,2,3,66.66666666666666
IRI,1988,Wrestling,0,0,1,1,1,100.0
IRI,1992,Wrestling,2,0,1,3,3,100.0
IRI,1996,Wrestling,1,1,1,3,3,100.0
IRI,2016,Wrestling,3,1,1,5,8,62.5
IRI,2020,Wrestling,2,1,1,4,7,57.14285714285714
IRI,2024,Wrestling,2,2,4,8,12,66.66666666666666
IRL,1924,Art Competitions,1,0,1,2,2,100.0
IRL,1928,Athletics,0,1,0,1,1,100.0
IRL,1932,Athletics,0,2,0,2,2,100.0
IRL,1948,Art Competitions,1,0,0,1,1,100.0
IRL,1952,Boxing,0,0,1,1,1,100.0
IRL,1956,Boxing,3,0,1,4,5,80.0
IRL,1964,Boxing,1,0,0,1,1,100.0
IRL,1980,Sailing,0,0,2,2,3,66.66666666666666
IRL,1984,Athletics,0,0,1,1,1,100.0
IRL,1992,Boxing,0,1,1,2,2,100.0
IRL,1996,Swimming,1,3,0,4,4,100.0
IRL,2000,Athletics,0,0,1,1,1,100.0
IRL,2008,Boxing,2,0,1,3,3,100.0
IRL,2012,Boxing,2,1,1,4,5,80.0
IRL,2016,Rowing,0,0,2,2,3,66.66666666666666
IRL,2020,Rowing,4,2,0,6,8,75.0
IRL,2024,Rowing,2,2,0,4,7,57.14285714285714
IRQ,1960,Weightlifting,1,0,0,1,1,100.0
ISL,1956,Athletics,0,0,1,1,1,100.0
ISL,1984,Judo,1,0,0,1,1,100.0
ISL,2000,Athletics,1,0,0,1,1,100.0
ISL,2008,Handball,0,0,14,14,14,100.0
ISR,1992,Judo,1,0,1,2,2,100.0
ISR,1996,Sailing,1,0,0,1,1,100.0
ISR,2000,Canoeing,1,0,0,1,1,100.0
ISR,2008,Sailing,1,0,0,1,1,100.0
ISR,2016,Judo,2,0,0,2,2,100.0
ISR,2020,Judo,11,0,0,11,14,78.57142857142857
ISV,1988,Sailing,0,0,1,1,1,100.0
ITA,1906,Rowing,17,18,3,38,56,67.85714285714286
ITA,1908,Fencing,0,0,5,5,8,62.5
ITA,1912,Gymnastics,1,19,0,20,25,80.0
JAM,1948,Athletics,0,1,2,3,3,100.0
JAM,1952,Athletics,0,5,3,8,8,100.0
JAM,1968,Athletics,0,0,1,1,1,100.0
JAM,1972,Athletics,1,0,0,1,1,100.0
JAM,1976,Athletics,0,1,1,2,2,100.0
JAM,1980,Athletics,2,0,0,2,3,66.66666666666666
JAM,1984,Athletics,2,0,5,7,7,100.0
JAM,1988,Athletics,0,0,7,7,7,100.0
JAM,1992,Athletics,1,0,3,4,4,100.0
JAM,1996,Athletics,12,1,3,16,16,100.0
JAM,2000,Athletics,3,0,20,23,23,100.0
JAM,2004,Athletics,6,6,1,13,13,100.0
JAM,2008,Athletics,6,5,3,14,14,100.0
JAM,2012,Athletics,8,8,9,25,25,100.0
JAM,2016,Athletics,2,11,17,30,30,100.0
JAM,2020,Athletics,11,9,1,21,21,100.0
JAM,2024,Athletics,2,1,3,6,6,100.0
JOR,2016,Taekwondo,0,1,0,1,1,100.0
JOR,2024,Taekwondo,0,0,1,1,1,100.0
JPN,1920,Tennis,0,0,3,3,3,100.0
JPN,1924,Wrestling,1,0,0,1,1,100.0
JPN,1928,Swimming,1,1,5,7,9,77.77777777777779
JPN,1936,Swimming,5,7,2,14,23,60.86956521739131
JPN,1956,Gymnastics,5,1,10,16,24,66.66666666666666
KAZ,2000,Boxing,0,2,2,4,7,57.14285714285714
KEN,1964,Athletics,1,0,0,1,1,100.0
KEN,1968,Athletics,1,3,7,11,12,91.66666666666666
KEN,1972,Athletics,2,5,2,9,12,75.0
KEN,1984,Athletics,1,1,0,2,3,66.66666666666666
KEN,1988,Athletics,1,4,2,7,9,77.77777777777779
KEN,1992,Athletics,2,2,4,8,8,100.0
KEN,1996,Athletics,3,1,4,8,8,100.0
KEN,2000,Athletics,2,2,3,7,7,100.0
KEN,2004,Athletics,2,1,4,7,7,100.0
KEN,2008,Athletics,5,6,4,15,15,100.0
KEN,2012,Athletics,5,2,4,11,11,100.0
KEN,2016,Athletics,1,6,6,13,13,100.0
KEN,2020,Athletics,2,4,4,10,10,100.0
KEN,2024,Athletics,5,4,2,11,11,100.0
KGZ,2000,Judo,1,0,0,1,1,100.0
KGZ,2008,Wrestling,1,0,1,2,2,100.0
KGZ,2020,Wrestling,1,0,2,3,3,100.0
KGZ,2024,Wrestling,4,0,1,5,6,83.33333333333334
KOR,1968,Boxing,1,0,1,2,2,100.0
KOR,1972,Judo,0,0,1,1,1,100.0
KOR,1976,Volleyball,12,0,0,12,17,70.58823529411765
KOS,2016,Judo,0,1,0,1,1,100.0
KOS,2020,Judo,0,2,0,2,2,100.0
KOS,2024,Judo,1,0,1,2,2,100.0
KSA,2012,Equestrianism,4,0,0,4,4,100.0
KSA,2020,Karate,0,0,1,1,1,100.0
KUW,2000,Shooting,1,0,0,1,1,100.0
KUW,2012,Shooting,1,0,0,1,1,100.0
KUW,2020,Shooting,1,0,0,1,1,100.0
LAT,1932,Athletics,0,0,1,1,1,100.0
LAT,1996,Canoeing,0,0,1,1,1,100.0
LAT,2012,Beach Volleyball,2,0,0,2,3,66.66666666666666
LAT,2020,3x3 Basketball,0,4,0,4,5,80.0
LCA,2024,Athletics,0,1,1,2,2,100.0
LIB,1952,Wrestling,1,0,1,2,2,100.0
LIB,1972,Weightlifting,0,0,1,1,1,100.0
LIB,1980,Wrestling,1,0,0,1,1,100.0
LTU,1992,Basketball,12,0,0,12,13,92.3076923076923
LTU,1996,Basketball,11,0,0,11,11,100.0
LTU,2000,Basketball,12,0,0,12,17,70.58823529411765
LTU,2004,Athletics,0,1,1,2,3,66.66666666666666
LTU,2016,Rowing,2,0,2,4,7,57.14285714285714
LTU,2020,Modern Pentathlon,0,0,1,1,1,100.0
LTU,2024,3x3 Basketball,4,0,0,4,7,57.14285714285714
LUX,1900,Athletics,0,1,0,1,1,100.0
LUX,1920,Weightlifting,0,0,1,1,1,100.0
LUX,1924,Art Competitions,0,1,1,2,2,100.0
LUX,1928,Art Competitions,0,1,0,1,1,100.0
LUX,1952,Athletics,0,1,0,1,1,100.0
MAR,1960,Athletics,0,0,1,1,1,100.0
MAR,1984,Athletics,0,2,0,2,2,100.0
MAR,1988,Athletics,1,1,0,2,3,66.66666666666666
MAR,1992,Athletics,0,1,1,2,3,66.66666666666666
MAR,1996,Athletics,2,0,0,2,2,100.0
MAR,2000,Athletics,3,0,1,4,5,80.0
MAR,2004,Athletics,0,2,1,3,3,100.0
MAR,2008,Athletics,1,0,1,2,2,100.0
MAR,2012,Athletics,1,0,0,1,1,100.0
MAR,2016,Boxing,1,0,0,1,1,100.0
MAR,2020,Athletics,0,1,0,1,1,100.0
MAR,2024,Football,19,0,0,19,20,95.0
MAS,1992,Badminton,2,0,0,2,2,100.0
MAS,1996,Badminton,1,0,2,3,3,100.0
MAS,2008,Badminton,0,0,1,1,1,100.0
MAS,2016,Badminton,0,0,5,5,8,62.5
MAS,2020,Badminton,2,0,0,2,3,66.66666666666666
MAS,2024,Badminton,3,0,0,3,3,100.0
MDA,1996,Canoeing,0,0,2,2,3,66.66666666666666
MDA,2008,Boxing,1,0,0,1,1,100.0
MDA,2012,Weightlifting,2,0,0,2,2,100.0
MDA,2020,Canoe Sprint,1,0,0,1,1,100.0
MEX,1900,Polo,3,0,0,3,3,100.0
MEX,1936,Basketball,11,0,0,11,16,68.75
MEX,1948,Equestrianism,3,4,1,8,9,88.88888888888889
MEX,1952,Diving,0,0,1,1,1,100.0
MEX,1956,Diving,1,1,0,2,2,100.0
MEX,1960,Diving,1,0,0,1,1,100.0
MEX,1964,Boxing,1,0,0,1,1,100.0
MEX,1972,Boxing,0,0,1,1,1,100.0
MEX,1980,Equestrianism,9,0,0,9,10,90.0
MEX,1992,Athletics,0,0,1,1,1,100.0
MEX,1996,Athletics,1,0,0,1,1,100.0
MEX,2012,Football,0,16,0,16,24,66.66666666666666
MEX,2020,Football,22,0,0,22,27,81.48148148148148
MGL,1968,Wrestling,3,0,1,4,4,100.0
MGL,1972,Wrestling,0,0,1,1,1,100.0
MGL,1976,Wrestling,0,0,1,1,1,100.0
MGL,1988,Boxing,1,0,0,1,1,100.0
MGL,1996,Judo,1,0,0,1,1,100.0
MGL,2004,Judo,1,0,0,1,1,100.0
MGL,2020,Judo,2,0,1,3,4,75.0
MGL,2024,Judo,0,0,1,1,1,100.0
MKD,2000,Wrestling,1,0,0,1,1,100.0
MKD,2020,Taekwondo,0,0,1,1,1,100.0
MNE,2012,Handball,0,0,14,14,14,100.0
MON,1924,Art Competitions,1,0,0,1,1,100.0
MOZ,1996,Athletics,1,0,0,1,1,100.0
MOZ,2000,Athletics,0,1,0,1,1,100.0
MRI,2008,Boxing,1,0,0,1,1,100.0
NAM,1992,Athletics,0,0,2,2,2,100.0
NAM,1996,Athletics,0,0,2,2,2,100.0
NAM,2020,Athletics,0,0,1,1,1,100.0
NED,1900,Rowing,9,3,5,17,27,62.96296296296296
NED,1906,Fencing,5,0,1,6,6,100.0
NED,1908,Football,12,0,0,12,16,75.0
NED,1912,Football,15,0,0,15,26,57.692307692307686
NED,1952,Hockey,0,0,11,11,18,61.111111111111114
NED,1960,Swimming,2,0,1,3,3,100.0
NED,1976,Water Polo,10,0,0,10,14,71.42857142857143
NED,1980,Swimming,4,0,0,4,6,66.66666666666666
NED,1988,Hockey,32,0,0,32,45,71.11111111111111
NGR,1964,Boxing,1,0,0,1,1,100.0
NGR,1972,Boxing,1,0,0,1,1,100.0
NGR,1984,Athletics,4,0,0,4,5,80.0
NGR,1992,Athletics,4,0,5,9,11,81.81818181818183
NGR,1996,Football,0,16,0,16,24,66.66666666666666
NGR,2000,Athletics,0,6,1,7,8,87.5
NGR,2004,Athletics,8,0,0,8,8,100.0
NGR,2008,Football,0,0,16,16,23,69.56521739130434
NGR,2016,Football,18,0,0,18,18,100.0
NIG,1972,Boxing,1,0,0,1,1,100.0
NIG,2016,Taekwondo,0,0,1,1,1,100.0
NOR,1900,Shooting,2,0,6,8,9,88.88888888888889
NOR,1904,Wrestling,0,2,0,2,2,100.0
NOR,1906,Gymnastics,0,20,0,20,25,80.0
NOR,1908,Gymnastics,0,0,30,30,42,71.42857142857143
NOR,1912,Gymnastics,22,24,0,46,80,57.49999999999999
NOR,1928,Sailing,0,4,1,5,9,55.55555555555556
NOR,1952,Sailing,0,3,8,11,13,84.61538461538461
NOR,1956,Athletics,2,1,0,3,3,100.0
NOR,1960,Sailing,0,2,0,2,2,100.0
NOR,1968,Canoeing,0,4,0,4,6,66.66666666666666
NOR,1976,Rowing,0,2,4,6,6,100.0
NOR,1988,Handball,0,0,14,14,22,63.63636363636363
NOR,1992,Handball,0,0,14,14,23,60.86956521739131
NOR,1996,Football,16,0,0,16,23,69.56521739130434
NOR,2008,Handball,0,14,0,14,22,63.63636363636363
NOR,2012,Handball,0,14,0,14,17,82.35294117647058
NOR,2016,Handball,14,0,0,14,19,73.68421052631578
NOR,2020,Handball,15,0,0,15,23,65.21739130434783
NOR,2024,Handball,0,15,0,15,23,65.21739130434783
NZL,1900,Water Polo,0,1,0,1,1,100.0
NZL,1920,Rowing,1,0,0,1,1,100.0
NZL,1924,Athletics,1,0,0,1,1,100.0
NZL,1928,Boxing,0,1,0,1,1,100.0
NZL,1932,Rowing,0,0,2,2,2,100.0
NZL,1936,Athletics,0,1,0,1,1,100.0
NZL,1952,Athletics,1,1,0,2,3,66.66666666666666
NZL,1956,Sailing,0,2,0,2,3,66.66666666666666
NZL,1960,Athletics,1,2,0,3,3,100.0
NZL,1964,Athletics,2,2,0,4,6,66.66666666666666
NZL,1968,Rowing,0,5,0,5,7,71.42857142857143
NZL,1972,Rowing,0,9,4,13,14,92.85714285714286
NZL,1976,Hockey,0,14,0,14,25,56.00000000000001
NZL,1996,Equestrianism,4,1,1,6,9,66.66666666666666
PAK,1956,Hockey,0,0,14,14,14,100.0
PAK,1960,Hockey,0,13,0,13,14,92.85714285714286
PAK,1964,Hockey,0,0,16,16,16,100.0
PAK,1968,Hockey,0,13,0,13,13,100.0
PAK,1972,Hockey,0,0,15,15,15,100.0
PAK,1976,Hockey,16,0,0,16,16,100.0
PAK,1984,Hockey,0,16,0,16,16,100.0
PAK,1988,Boxing,1,0,0,1,1,100.0
PAK,1992,Hockey,16,0,0,16,16,100.0
PAK,2024,Athletics,0,1,0,1,1,100.0
PAN,1948,Athletics,2,0,0,2,2,100.0
PAN,2008,Athletics,0,1,0,1,1,100.0
PAN,2024,Boxing,0,0,1,1,1,100.0
PAR,2004,Football,0,0,17,17,17,100.0
PER,1948,Shooting,0,1,0,1,1,100.0
PER,1984,Shooting,0,0,1,1,1,100.0
PER,1988,Volleyball,0,0,12,12,12,100.0
PER,1992,Shooting,0,0,1,1,1,100.0
PER,2024,Sailing,1,0,0,1,1,100.0
PHI,1928,Swimming,1,0,0,1,1,100.0
PHI,1936,Athletics,1,0,0,1,1,100.0
PHI,1964,Boxing,0,0,1,1,1,100.0
PHI,1988,Boxing,1,0,0,1,1,100.0
PHI,1992,Boxing,1,0,0,1,1,100.0
PHI,1996,Boxing,0,0,1,1,1,100.0
PHI,2016,Weightlifting,0,0,1,1,1,100.0
PHI,2020,Boxing,1,0,2,3,4,75.0
POL,1924,Cycling,0,0,4,4,5,80.0
POL,2020,Athletics,3,14,6,23,36,63.888888888888886
POR,1924,Equestrianism,4,0,0,4,4,100.0
POR,1928,Fencing,6,0,0,6,6,100.0
POR,1936,Equestrianism,3,0,0,3,3,100.0
POR,1948,Equestrianism,3,0,0,3,5,60.0
POR,1952,Sailing,2,0,0,2,2,100.0
POR,1960,Sailing,0,0,2,2,2,100.0
POR,1984,Athletics,2,1,0,3,3,100.0
POR,1988,Athletics,0,1,0,1,1,100.0
POR,1996,Sailing,2,0,0,2,3,66.66666666666666
POR,2004,Athletics,1,0,1,2,3,66.66666666666666
POR,2012,Canoeing,0,0,2,2,2,100.0
POR,2016,Judo,1,0,0,1,1,100.0
POR,2024,Cycling Track,0,2,1,3,5,60.0
PRK,1972,Volleyball,11,0,0,11,15,73.33333333333333
PRK,1976,Boxing,0,1,1,2,2,100.0
PRK,2012,Weightlifting,1,3,0,4,6,66.66666666666666
PRK,2016,Weightlifting,0,1,3,4,7,57.14285714285714
PUR,1948,Boxing,1,0,0,1,1,100.0
PUR,1976,Boxing,1,0,0,1,1,100.0
PUR,1984,Boxing,1,0,1,2,2,100.0
PUR,1992,Boxing,1,0,0,1,1,100.0
PUR,1996,Boxing,1,0,0,1,1,100.0
PUR,2016,Tennis,0,1,0,1,1,100.0
PUR,2020,Athletics,0,1,0,1,1,100.0
QAT,1992,Athletics,1,0,0,1,1,100.0
QAT,2000,Weightlifting,1,0,0,1,1,100.0
QAT,2016,Athletics,0,0,1,1,1,100.0
QAT,2024,Athletics,1,0,0,1,1,100.0
ROU,1924,Rugby,16,0,0,16,16,100.0
ROU,1936,Equestrianism,0,0,1,1,1,100.0
ROU,1964,Canoeing,7,0,2,9,16,56.25
ROU,1988,Rowing,12,2,22,36,58,62.06896551724138
ROU,1992,Rowing,3,6,24,33,53,62.264150943396224
ROU,2004,Gymnastics,8,9,3,20,39,51.28205128205128
ROU,2016,Rowing,9,0,0,9,16,56.25
ROU,2020,Rowing,0,2,6,8,9,88.88888888888889
ROU,2024,Rowing,0,11,6,17,21,80.95238095238095
RSA,1908,Athletics,0,1,1,2,2,100.0
RSA,1912,Tennis,0,3,1,4,7,57.14285714285714
RSA,1924,Athletics,1,0,1,2,3,66.66666666666666
RSA,1928,Swimming,4,0,0,4,6,66.66666666666666
RSA,1932,Boxing,1,2,0,3,5,60.0
RSA,1936,Boxing,0,0,1,1,1,100.0
RSA,1948,Boxing,1,2,1,4,6,66.66666666666666
RSA,1956,Swimming,4,0,0,4,7,57.14285714285714
RSA,1960,Boxing,1,0,1,2,3,66.66666666666666
RSA,1992,Tennis,0,0,2,2,3,66.66666666666666
RSA,1996,Swimming,1,2,0,3,5,60.0
RSA,2000,Athletics,2,0,1,3,5,60.0
RSA,2004,Swimming,1,4,1,6,10,60.0
RSA,2008,Athletics,0,0,1,1,1,100.0
RSA,2016,Rugby Sevens,13,0,0,13,23,56.52173913043478
RSA,2020,Swimming,0,1,1,2,3,66.66666666666666
RSA,2024,Rugby Sevens,13,0,0,13,21,61.904761904761905
RUS,1908,Wrestling,0,0,2,2,3,66.66666666666666
SCG,2000,Water Polo,13,0,0,13,25,52.0
SCG,2004,Water Polo,0,0,12,12,13,92.3076923076923
SEN,1988,Athletics,0,0,1,1,1,100.0
SGP,1960,Weightlifting,0,0,1,1,1,100.0
SGP,2008,Table Tennis,0,0,3,3,3,100.0
SGP,2012,Table Tennis,4,0,0,4,4,100.0
SGP,2016,Swimming,0,1,0,1,1,100.0
SGP,2024,Sailing,1,0,0,1,1,100.0
SLO,1992,Rowing,6,0,0,6,6,100.0
SLO,2000,Rowing,0,2,0,2,3,66.66666666666666
SMR,2020,Shooting,1,0,2,3,4,75.0
SRB,2008,Water Polo,13,0,0,13,15,86.66666666666667
SRB,2012,Water Polo,13,0,0,13,16,81.25
SRI,1948,Athletics,0,0,1,1,1,100.0
SRI,2000,Athletics,0,0,1,1,1,100.0
SUD,2008,Athletics,0,0,1,1,1,100.0
SUI,1896,Gymnastics,0,1,2,3,3,100.0
SUI,1900,Shooting,1,13,1,15,21,71.42857142857143
SUI,1904,Gymnastics,1,1,0,2,3,66.66666666666666
SUI,1906,Shooting,1,8,3,12,12,100.0
SUI,1912,Art Competitions,0,2,0,2,2,100.0
SUI,1920,Shooting,17,0,0,17,29,58.620689655172406
SUI,1928,Gymnastics,2,12,2,16,30,53.333333333333336
SUI,1932,Gymnastics,0,0,1,1,1,100.0
SUI,1956,Equestrianism,3,0,0,3,3,100.0
SUI,1964,Equestrianism,0,1,3,4,6,66.66666666666666
SUI,1972,Fencing,0,0,5,5,8,62.5
SUI,1988,Equestrianism,1,0,4,5,8,62.5
SUI,1992,Tennis,0,1,0,1,1,100.0
SUR,1988,Swimming,0,1,0,1,1,100.0
SUR,1992,Swimming,1,0,0,1,1,100.0
SVK,1996,Canoeing,0,1,1,2,3,66.66666666666666
SVK,2000,Canoeing,1,2,1,4,6,66.66666666666666
SVK,2004,Canoeing,4,3,1,8,10,80.0
SVK,2008,Canoeing,0,4,4,8,10,80.0
SVK,2012,Canoeing,3,0,0,3,5,60.0
SVK,2016,Canoeing,0,2,5,7,8,87.5
SVK,2020,Canoe Sprint,4,0,0,4,7,57.14285714285714
SVK,2024,Canoe Slalom,1,0,0,1,1,100.0
SWE,1900,Tug-Of-War,0,3,0,3,4,75.0
SWE,1906,Athletics,5,2,4,11,21,52.38095238095239
SWE,1968,Cycling,1,0,4,5,9,55.55555555555556
SWE,1996,Handball,0,0,16,16,31,51.61290322580645
SWE,2012,Handball,0,0,14,14,22,63.63636363636363
SWE,2016,Football,0,0,18,18,28,64.28571428571429
SWE,2020,Football,0,0,22,22,34,64.70588235294117
SYR,1984,Wrestling,0,0,1,1,1,100.0
SYR,1996,Athletics,0,1,0,1,1,100.0
SYR,2004,Boxing,1,0,0,1,1,100.0
SYR,2020,Weightlifting,1,0,0,1,1,100.0
TAN,1980,Athletics,0,0,2,2,2,100.0
TCH,1920,Ice Hockey,8,0,0,8,10,80.0
TCH,1924,Gymnastics,4,1,4,9,10,90.0
TCH,1928,Gymnastics,1,1,10,12,16,75.0
TCH,1948,Gymnastics,3,8,0,11,20,55.00000000000001
TCH,1972,Handball,0,0,16,16,29,55.172413793103445
TGA,1996,Boxing,0,0,1,1,1,100.0
THA,1976,Boxing,1,0,0,1,1,100.0
THA,1984,Boxing,0,0,1,1,1,100.0
THA,1988,Boxing,1,0,0,1,1,100.0
THA,1992,Boxing,1,0,0,1,1,100.0
THA,1996,Boxing,1,1,0,2,2,100.0
THA,2000,Boxing,1,1,0,2,3,66.66666666666666
THA,2016,Weightlifting,1,2,1,4,6,66.66666666666666
TJK,2012,Boxing,1,0,0,1,1,100.0
TJK,2016,Athletics,0,1,0,1,1,100.0
TJK,2024,Judo,2,0,0,2,3,66.66666666666666
TKM,2020,Weightlifting,0,0,1,1,1,100.0
TOG,2008,Canoeing,1,0,0,1,1,100.0
TPE,1960,Athletics,0,0,1,1,1,100.0
TPE,1968,Athletics,1,0,0,1,1,100.0
TPE,1984,Weightlifting,1,0,0,1,1,100.0
TPE,1992,Baseball,0,0,20,20,20,100.0
TPE,1996,Table Tennis,0,0,1,1,1,100.0
TPE,2004,Archery,3,0,3,6,9,66.66666666666666
TPE,2016,Archery,3,0,0,3,5,60.0
TTO,1948,Weightlifting,0,0,1,1,1,100.0
TTO,1952,Weightlifting,2,0,0,2,2,100.0
TTO,1964,Athletics,5,0,1,6,6,100.0
TTO,1976,Athletics,0,1,0,1,1,100.0
TTO,1996,Athletics,2,0,0,2,2,100.0
TTO,2000,Athletics,1,0,1,2,2,100.0
TTO,2004,Swimming,1,0,0,1,1,100.0
TTO,2008,Athletics,0,5,1,6,6,100.0
TTO,2012,Athletics,5,1,4,10,10,100.0
TTO,2016,Athletics,1,0,0,1,1,100.0
TUN,1968,Athletics,1,1,0,2,2,100.0
TUN,1972,Athletics,0,0,1,1,1,100.0
TUN,1996,Boxing,1,0,0,1,1,100.0
TUN,2008,Swimming,0,1,0,1,1,100.0
TUN,2012,Swimming,1,1,0,2,3,66.66666666666666
TUN,2024,Taekwondo,1,1,0,2,3,66.66666666666666
TUR,1936,Wrestling,1,1,0,2,2,100.0
TUR,1948,Wrestling,1,6,4,11,12,91.66666666666666
TUR,1952,Wrestling,1,2,0,3,3,100.0
TUR,1956,Wrestling,2,3,2,7,7,100.0
TUR,1960,Wrestling,0,7,2,9,9,100.0
TUR,1964,Wrestling,1,2,3,6,6,100.0
TUR,1968,Wrestling,0,2,0,2,2,100.0
TUR,1972,Wrestling,0,0,1,1,1,100.0
TUR,1984,Boxing,2,0,0,2,3,66.66666666666666
TUR,1992,Wrestling,1,1,2,4,6,66.66666666666666
TUR,2016,Wrestling,2,1,2,5,8,62.5
UAE,2004,Shooting,0,1,0,1,1,100.0
UAE,2016,Judo,1,0,0,1,1,100.0
UGA,1968,Boxing,1,0,1,2,2,100.0
UGA,1980,Boxing,0,0,1,1,1,100.0
UGA,1996,Athletics,1,0,0,1,1,100.0
UGA,2012,Athletics,0,1,0,1,1,100.0
UGA,2020,Athletics,1,2,1,4,4,100.0
UGA,2024,Athletics,0,1,1,2,2,100.0
URU,1924,Football,0,14,0,14,14,100.0
URU,1928,Football,0,17,0,17,17,100.0
URU,1932,Rowing,1,0,0,1,1,100.0
URU,1948,Rowing,2,0,1,3,3,100.0
URU,1952,Basketball,12,0,0,12,14,85.71428571428571
URU,1956,Basketball,12,0,0,12,12,100.0
URU,1964,Boxing,1,0,0,1,1,100.0
URU,2000,Cycling,0,0,1,1,1,100.0
USA,1896,Athletics,2,9,6,17,20,85.0
USA,1900,Athletics,10,16,13,39,63,61.904761904761905
USA,1906,Athletics,6,11,6,23,24,95.83333333333334
USA,1908,Athletics,8,19,14,41,65,63.07692307692307
UZB,2000,Boxing,2,1,0,3,4,75.0
UZB,2004,Wrestling,0,2,1,3,5,60.0
UZB,2016,Boxing,2,3,2,7,13,53.84615384615385
VEN,1952,Athletics,1,0,0,1,1,100.0
VEN,1960,Shooting,1,0,0,1,1,100.0
VEN,1968,Boxing,0,1,0,1,1,100.0
VEN,1976,Boxing,0,0,1,1,1,100.0
VEN,1980,Boxing,0,0,1,1,1,100.0
VEN,1984,Boxing,2,0,0,2,3,66.66666666666666
VEN,2008,Taekwondo,1,0,0,1,1,100.0
VEN,2012,Fencing,0,1,0,1,1,100.0
VIE,2000,Taekwondo,0,0,1,1,1,100.0
VIE,2008,Weightlifting,0,0,1,1,1,100.0
VIE,2016,Shooting,0,1,1,2,2,100.0
WIF,1960,Athletics,5,0,0,5,5,100.0
YUG,1924,Gymnastics,0,2,0,2,2,100.0
YUG,1928,Gymnastics,10,1,1,12,12,100.0
YUG,1936,Gymnastics,0,0,1,1,1,100.0
YUG,1948,Football,0,0,15,15,16,93.75
YUG,1956,Football,0,0,14,14,23,60.86956521739131
YUG,1960,Football,0,16,0,16,17,94.11764705882352
YUG,1964,Water Polo,0,0,11,11,15,73.33333333333333
YUG,1972,Handball,0,14,0,14,18,77.77777777777779
YUG,1976,Basketball,0,0,12,12,19,63.1578947368421
ZAM,1984,Boxing,1,0,0,1,1,100.0
ZAM,1996,Athletics,0,0,1,1,1,100.0
ZAM,2024,Athletics,1,0,0,1,1,100.0
ZIM,1980,Hockey,0,15,0,15,15,100.0
ZIM,2004,Swimming,1,1,1,3,3,100.0
ZIM,2008,Swimming,0,1,3,4,4,100.0
